{
  "width" : 9,
  "height" : 9,
  "layout" : [ [0, 1, 1, 0, 0, 0, 1, 1, 0 ],
              [1, 1, 1, 1, 1, 1, 1, 1, 1 ],
              [1, 1, 1, 1, 1, 1, 1, 1, 1 ],
              [1, 1, 1, 1, 1, 1, 1, 1, 1 ],
              [0, 0, 1, 1, 1, 1, 1, 0, 0 ],
              [1, 1, 1, 1, 1, 1, 1, 1, 1 ],
              [1, 1, 1, 1, 1, 1, 1, 1, 1 ],
              [1, 1, 1, 1, 1, 1, 1, 1, 1 ],
              [0, 1, 1, 0, 0, 0, 1, 1, 0 ] ]
}